##########################################################################################################
####  #    #     ###                     ## ##   ###    ###      ########  ##   ####        ##          ##
###  ###      ##       ######   ###   #  ##        #    ##    #    #####      #####   ###    #  ##      ##
##        ##   ##   #   ##       #       ##  #           ##               #     ####### ###     #  ###  ##
###        #        ##   ##   #   ####   ##      ###         #   ###    ###  #  ##        ##      ##    ##
####   ##            ##    ##           ####    ## ####      ######     ####   ###   #                  ##
###    ###    ###############     #    ##     ###   ##   #  ###           ###  ##    # ##  ##    ###    ##
##    ##  #   ##      #   ##          ##  # ###   #  ##    ##     ##  ##    ######    ##    ###         ##
##   ##      ##   #       ##   ##      ##   ##        ##  ##     ##  ####      ##     ###########   ##  ##
##          ##           ##     #    #  ## ##     ##    ######     ##          ###   ##      ####    ## ##
###    ##           #   ##   #  #    #   ##     ###       # ##                ##   ######     ##        ##
####    #     ###        ##     #     #       #####                  #####    ## ##           ####   #  ##
#####     #     ####    ###     ##            ##  ##   ######           #      ##      #####     ##  #  ##
##################     ##    #         ##    ##   #   ##   ###   ##    #    ####  #      ####    ##     ##
######                  ###      #    ##    ###       ###    ##   ##  ##   ###   ##     ##  ##    ###   ##
####   #    #    #        ##    ###  ##               ##      ##   ###    ##           ##               ##
###        # #      #     ##          #   ##    ##    #####    ##        ##   #####    #####   ####  #  ##
##          #       #   ##   #   ##  ##        ##      ##   #   ##      ########  #    ###           #  ##
##   #             ##  ##  ###       ##  #      ##      ###            ##               ##    ##    ######
####              ##  ##   #    ##  ##         ##   #    ##   #   ## ##               ###      ##     ####
############         ##         #  ##     ###  ##         ##  ##   ##         #####    ###   ###       ###
####     ####   ######  #   #     ##    ### ###     ##   ##    #  #######   ###        ##   ###    #   ###
### ##     #      ##   ##    ##  ###  ####           #  ###            ##     ###       ##  ##     #    ##
##            #  ####         #   #####  ###    ###      ####    ##         ###     ##  #####     ###   ##
##   ###     ## ##    ###  #  ##          ####   ###      ##   ####  #  ######      ##            #   ####
##########################################################################################################